3 8 4 4 4 4 4 4 4 5 5 4 4 4 4 4 4 4 9 3
3 8 5 5 5 5 5 5 5 5 5 5 5 5 5 5 5 5 9 3
3 8 5 5 5 5 5 5 5 5 5 5 5 5 5 5 5 5 9 3
3 8 5 5 5 5 5 5 5 5 5 5 5 5 5 5 5 5 9 3
3 8 5 5 5 5 5 5 5 5 5 5 5 5 5 5 5 5 5 5
3 8 5 5 5 5 5 5 5 5 5 5 5 5 5 5 5 5 9 3
3 8 5 5 5 5 5 5 5 5 5 5 5 5 5 5 5 5 9 3
3 8 5 5 5 5 5 5 5 5 5 5 5 5 5 5 5 5 9 3
3 13 7 7 7 7 7 7 7 7 7 7 7 7 7 7 7 7 12 3
3 3 3 3 3 3 3 3 3 3 3 3 3 3 3 3 3 3 3 3
3 3 3 3 3 3 3 3 3 3 3 3 3 3 3 3 3 3 3 3