3 8 4 4 4 4 4 4 4 4 4 4 4 4 4 4 4 4 9 3
3 8 1 2 0 1 2 0 1 2 0 1 2 0 1 2 0 1 9 3
3 8 0 1 2 0 1 2 0 1 2 0 1 2 0 1 2 0 9 3
3 8 2 0 1 2 0 1 2 0 1 2 0 1 2 0 1 2 9 3
3 8 1 2 0 1 2 0 1 2 0 1 2 0 1 2 0 1 2 0
3 8 0 1 2 0 1 2 0 1 2 0 1 2 0 1 2 0 9 3
3 8 2 0 1 2 0 1 2 0 1 2 0 1 2 0 1 2 9 3
3 8 1 2 0 1 2 0 1 2 0 1 2 0 1 2 0 1 9 3
3 13 7 7 7 7 7 7 7 7 7 7 7 7 7 7 7 7 12 3
3 3 3 3 3 3 3 3 3 3 3 3 3 3 3 3 3 3 3 3
3 3 3 3 3 3 3 3 3 3 3 3 3 3 3 3 3 3 3 3